                           XXXXX     XXXXXXXX
                           X   X     X      X
  XXXXXXXXXXX              X   X     X      X
XXX         X              X   XXXXXXX      X 
X           X              X                X
X           X     XXXX   XXX                X
XX   XXXXX  X     X  XX  XX   XXXXXXXXXXXX  X
XX P X   X  XXXX  X   X  X    XXXXXXXXXXXX  X
XXXXXX   X     X  X   XXXX    XXXXXXXXXXXX  X
         X     XXXX              XXXXXXXXX  XXXX
         XXXX                    XXCCCXXXX     X
            X                 XXXX             X
            X  XXX  XXXXXXXX  X                X
            X  XXX  X      X  XXXXXXXXXXXXXXXXXX
            X  XXX  X      X  X
            X  XXX  XXXXXXXX  X
            X  XXX  X         X
            X  X    X         X
            X  XC   XXX  XXX  X
            X       XXX  XXX  XXXXXXXXXXXXXX
            X       XXX  XXX  X            X
            XXXXXXXXXXX  XXX  X            X       XXXXX
            X            XXX  XXXXX  XXXXXXXXXXXXXX     X
            X            XXX  XXXX   X               E  X
            X            XXX         X                  X
            X            XXX         X     XXXXXXXX  C  X
            XXXXXXXXXXXXXXXX  XXXXXXXX     X       XXXXX
                           X  XXXXX        X
                           X               X
                           X               X
                XXXXX    XXX  XXXX  XXXXXXXX
                X C XXXXXX    X  X  XXXXXX
                X             X  X       X
                X             X  X       X
                X  XXXXXX     X  XXXXXXXXX
                XXXX    XXXXXXX